107
8
22 0 0 0 0 0 0 0 0 0 0 0 0 0 0 0 0 0 0 0 0 0 0 0 0 0 0 0 0 0 0 0 0 0 0 0 0 0 0 0 0 0 0 0 24 24 24 24 24 24 24 24 24 24 24 24 24 24 24 24 24 24 24 24 24 24 24 24 24 24 24 24 24 24 24 0 0 0 0 0 0 0 0 0 0 0 0 0 0 0 0 24 24 24 24 24 24 24 24 24 24 24 24 24 24 24 24 
22 0 0 0 0 0 0 0 0 0 0 0 0 0 0 0 0 0 0 0 0 0 0 0 0 0 0 0 0 0 0 0 0 0 0 0 0 0 0 0 0 0 0 0 0 24 24 24 24 24 24 24 24 24 24 24 24 24 24 24 0 0 0 0 0 0 0 0 0 0 0 24 24 24 24 0 0 0 0 0 0 0 0 0 0 0 0 0 0 0 0 0 24 24 24 24 24 0 0 0 0 0 0 0 0 0 24 
22 0 0 0 0 0 0 0 0 0 0 0 13 0 0 0 0 0 0 0 0 0 0 0 0 0 0 0 0 0 0 0 0 0 0 0 14 0 0 10 0 0 0 0 0 0 0 0 0 24 24 24 24 24 1 2 3 24 24 24 0 0 0 0 0 0 0 0 0 0 0 0 0 24 24 0 0 0 0 0 0 0 0 0 0 0 0 0 0 0 0 0 0 24 24 24 24 0 0 0 0 0 0 0 0 0 24 
22 0 0 0 0 0 0 0 0 0 0 0 0 0 0 11 0 0 0 0 0 0 0 0 0 0 0 0 0 0 0 0 0 0 11 0 0 0 21 21 0 0 21 21 0 0 16 0 0 0 0 0 24 24 24 24 24 24 24 0 0 0 0 0 11 10 0 0 0 0 0 0 0 0 0 0 0 0 0 0 0 0 0 0 0 21 0 0 0 0 0 0 0 0 24 24 24 0 0 0 0 0 0 0 0 0 24 
22 0 0 0 0 12 0 0 0 0 0 0 11 0 21 21 21 0 0 0 0 0 0 0 0 0 0 15 0 0 0 0 0 21 21 0 0 0 0 0 0 0 0 0 0 0 11 0 0 0 0 0 0 0 0 0 0 0 0 0 0 0 0 0 21 21 21 0 0 0 0 0 0 0 0 0 0 0 0 21 21 21 0 0 0 22 0 0 0 0 0 0 0 0 0 24 24 0 0 0 0 0 0 0 0 0 24
22 0 0 0 0 0 0 0 0 0 0 21 21 21 24 24 0 0 0 0 0 0 10 0 0 0 0 0 0 0 10 0 0 0 0 0 0 11 0 0 0 0 0 0 0 21 21 21 0 0 0 0 0 0 0 0 0 0 0 0 0 0 0 0 24 24 24 0 0 21 21 0 0 0 0 0 0 0 0 0 0 0 0 0 0 22 0 0 0 0 0 0 0 0 0 0 0 0 0 0 0 0 0 0 0 0 24 
22 0 0 0 10 0 0 0 0 0 0 24 24 24 24 24 0 0 0 21 21 21 21 21 21 0 0 0 0 0 21 21 0 0 0 0 21 21 0 0 0 0 0 0 0 24 24 24 0 10 0 0 21 0 0 0 0 0 21 11 0 0 0 21 24 24 24 0 0 0 0 0 0 0 0 0 10 0 0 0 11 0 0 0 21 24 21 0 0 0 0 0 0 0 0 0 0 0 0 10 11 0 0 0 0 0 24 
22 21 21 21 21 21 21 21 21 21 21 24 24 24 24 24 0 0 0 0 24 24 24 24 24 21 21 21 21 21 24 24 21 21 21 21 24 24 0 0 0 0 0 0 0 24 24 24 21 21 21 21 24 21 21 21 21 21 24 21 21 21 21 24 24 0 0 0 0 0 0 0 21 21 21 21 21 21 21 21 21 21 21 21 24 24 24 21 21 21 21 21 21 21 21 21 21 21 21 21 21 21 21 21 21 21 24 
