107
8
22 0 0 0 0 0 0 0 0 0 0 0 0 0 0 0 0 0 0 0 0 0 0 0 0 0 0 0 0 0 0 0 0 0 0 0 0 0 0 0 0 0 0 0 0 0 0 0 0 0 0 0 0 0 0 0 0 0 0 0 0 0 0 0 0 0 0 0 24 24 24 24 24 24 24 0 0 0 0 0 0 0 0 0 0 0 0 0 0 0 0 0 0 0 0 0 0 0 0 0 0 0 0 0 0 0 24 
22 0 0 0 0 0 0 0 0 0 0 0 0 0 0 0 0 0 0 0 0 0 0 0 0 0 0 0 0 0 0 0 0 0 0 0 0 0 0 0 0 0 0 0 0 0 0 0 0 0 0 0 0 0 0 0 0 0 0 0 0 0 0 0 0 0 0 0 0 0 0 24 24 24 24 0 0 0 0 0 0 0 0 0 0 0 0 0 0 0 0 0 0 0 0 0 0 0 0 0 0 0 0 0 0 0 24 
22 0 0 0 0 0 0 0 0 0 0 0 0 0 0 0 0 0 0 0 0 0 0 0 0 0 0 0 0 0 0 0 0 0 0 0 0 0 0 10 0 0 0 0 0 0 0 0 0 0 0 27 26 0 0 0 0 0 27 26 0 0 0 0 0 0 0 0 0 0 0 0 0 24 24 0 0 0 0 0 0 0 0 0 0 0 0 0 0 0 0 0 0 0 0 0 0 0 0 0 0 0 0 0 6 0 24 
22 0 0 0 0 0 0 0 0 0 0 0 0 0 0 0 11 0 0 0 0 0 0 0 0 0 0 0 0 0 0 0 0 0 11 0 0 0 27 26 0 0 0 0 0 0 0 27 26 0 0 0 24 21 21 21 21 21 24 0 0 0 0 0 11 10 0 0 0 0 0 0 0 0 0 0 0 0 0 0 0 10 0 0 0 21 0 0 0 0 0 0 0 21 0 0 0 0 0 0 0 27 21 21 21 21 24 
22 21 21 21 21 26 0 0 0 27 26 0 0 11 27 21 26 0 0 0 0 0 0 0 0 0 0 0 0 0 0 0 0 27 26 0 0 0 0 0 0 0 27 21 26 0 0 0 0 0 0 0 0 0 0 0 0 0 0 0 0 0 0 0 27 21 26 0 0 0 0 0 0 0 0 0 0 0 0 0 27 26 0 0 0 22 0 0 0 0 0 0 11 24 0 0 0 0 0 27 21 24 24 24 24 24 24
22 24 24 24 24 24 26 0 0 0 0 0 0 27 24 24 0 0 0 0 0 0 10 0 0 0 0 0 0 0 10 0 0 0 0 0 0 11 0 0 0 0 0 0 0 0 0 0 0 0 0 0 0 0 0 0 0 0 0 0 0 0 0 0 24 24 24 0 0 27 26 0 0 0 0 0 0 0 0 27 24 0 0 0 0 22 26 0 0 0 0 0 27 24 21 21 21 21 21 24 24 24 24 24 24 24 24 
22 24 24 24 24 24 24 0 0 0 0 0 0 24 24 24 0 0 0 27 21 21 21 21 26 0 0 0 0 0 27 26 0 0 0 0 27 26 0 0 0 0 0 0 0 0 0 0 0 0 10 0 21 0 0 0 0 0 21 11 0 0 0 27 24 24 24 0 0 0 0 0 0 0 0 0 0 0 0 0 0 0 0 11 27 24 24 0 0 0 27 21 24 24 24 24 24 24 24 24 24 24 24 24 24 24 24 
22 24 24 24 24 24 24 0 0 0 0 0 0 24 24 24 0 0 0 0 24 24 24 24 24 21 21 21 21 21 24 24 21 21 21 21 24 24 0 0 0 0 0 0 0 0 0 0 0 0 27 21 24 21 21 21 21 21 24 21 21 21 21 24 24 0 0 0 0 0 0 0 27 21 21 21 26 0 0 0 0 0 21 21 24 24 24 21 21 21 24 24 24 24 24 24 24 24 24 24 24 24 24 24 24 24 24 
