107
8
22 0 0 0 0 0 0 0 0 0 0 0 0 0 0 0 0 0 0 0 0 0 0 0 0 0 0 0 0 0 0 0 0 0 0 0 0 0 0 0 0 0 0 0 24 24 24 24 24 24 24 24 24 24 24 24 24 24 24 24 24 24 24 24 24 24 24 24 24 24 24 24 24 24 24 0 0 0 0 0 0 0 0 0 0 0 0 0 0 0 0 24 24 24 24 24 24 24 24 24 24 24 24 24 24 24 24 
22 0 0 0 0 0 0 0 0 0 0 0 0 0 0 0 0 0 0 0 0 0 0 0 0 0 0 0 0 0 0 0 0 0 0 0 0 0 0 0 0 0 0 0 0 24 24 24 24 24 24 24 24 24 24 24 24 24 24 24 0 0 0 0 0 0 0 0 0 0 0 24 24 24 24 0 0 0 0 0 0 0 0 0 0 0 0 0 0 0 0 0 24 24 24 24 24 0 0 0 0 0 0 0 0 0 24                     
22 0 0 0 0 0 0 0 0 0 0 0 13 0 0 0 0 0 0 0 0 0 0 0 0 0 0 0 0 0 0 0 0 0 0 0 14 0 0 10 0 0 0 0 0 0 0 0 0 24 24 24 24 24 2 3 4 24 24 24 0 0 0 0 0 0 0 0 0 0 0 0 0 24 24 0 0 0 0 0 0 0 0 0 0 0 0 0 0 0 0 0 0 24 24 24 24 0 0 0 0 0 0 0 0 0 24 
22 0 0 0 0 0 0 0 0 0 0 0 0 0 0 11 0 0 0 0 0 0 0 0 0 0 0 0 0 0 0 0 0 0 11 0 0 0 27 26 0 0 27 26 0 0 16 0 0 0 0 0 24 24 24 24 24 24 24 0 0 0 0 0 11 10 0 0 0 0 0 0 0 0 0 0 0 0 0 0 0 0 0 0 0 21 0 0 0 0 0 0 0 0 24 24 24 0 0 0 0 0 0 0 0 0 24 
22 0 0 0 0 12 0 0 0 0 0 0 11 0 27 21 26 0 0 0 0 0 0 0 0 0 0 15 0 0 0 0 0 27 26 0 0 0 0 0 0 0 0 0 0 0 11 0 0 0 0 0 0 0 0 0 0 0 0 0 0 0 0 0 27 21 26 0 0 0 0 0 0 0 0 0 0 0 0 27 21 26 0 0 0 22 0 0 0 0 0 0 0 0 0 24 24 0 0 0 0 0 0 0 0 0 24
22 0 0 0 0 0 0 0 0 0 0 27 21 21 24 24 0 0 0 0 0 0 10 0 0 0 0 0 0 0 10 0 0 0 0 0 0 11 0 0 0 0 0 0 0 27 21 26 0 0 0 0 0 0 0 0 0 0 0 0 0 0 0 0 24 24 24 0 0 27 26 0 0 0 0 0 0 0 0 0 0 0 0 0 0 22 26 0 0 0 0 0 0 0 0 0 0 0 0 0 0 0 0 0 0 0 24 
22 0 0 0 10 0 0 0 0 0 0 24 24 24 24 24 0 0 0 27 21 21 21 21 26 0 0 0 0 0 27 26 0 0 0 0 27 26 0 0 0 0 0 0 0 24 24 24 0 10 0 0 21 0 0 0 0 0 21 0 0 0 0 27 24 24 24 0 0 0 0 0 0 0 0 0 10 0 0 0 11 0 0 0 27 24 24 0 0 0 0 0 0 0 0 0 0 0 0 10 11 0 0 7 8 0 24 
22 21 21 21 21 21 21 21 21 21 21 24 24 24 24 24 0 0 0 0 24 24 24 24 24 21 21 21 21 21 24 24 21 21 21 21 24 24 0 0 0 0 0 0 0 24 24 24 21 21 21 21 24 21 21 21 21 21 24 21 21 21 21 24 24 0 0 0 0 0 0 0 27 21 21 21 21 21 21 21 21 21 21 21 24 24 24 21 21 21 21 21 21 21 21 21 21 21 21 21 21 21 21 21 21 21 24 
